8 	11
###########
#         #
#### ######
#    #    #
#    #    # 
# ###### ##
#         #
###########





