###########
#   >>H   #
####^######
#   G#    #
#    #    #
# ###### ##
#         #
###########
